9 9 100 8
0 S 0 -1 -1 -1 -1 0 -1
-1 0 -1 0 F2 0 0 0 -1
-1 0 -1 0 -1 0 0 0 0
-1 0 0 0 0 -1 0 0 0
0 -1 -1 -1 3 0 0 0 0
0 0 0 0 -1 0 -1 0 -1
0 0 G 0 0 F3 -1 0 -1
0 0 0 0 0 -1 0 0 -1
0 -1 0 -1 -1 -1 -1 0 0
