9 9 100 100
0 -1 0 0 -1 -1 -1 0 -1
0 0 0 0 1 0 -1 0 0
0 -1 0 0 50 0 0 0 0
0 0 -1 0 -1 0 0 0 -1
-1 0 0 0 -1 0 -1 0 -1
0 0 0 -1 -1 0 0 0 -1
-1 -1 0 -1 -1 0 -1 -1 -1
-1 0 S -1 -1 0 0 0 G
-1 -1 0 0 -1 0 -1 0 0