9 9 100 12
0 0 0 -1 -1 0 0 0 -1
0 0 0 0 -1 0 -1 -1 0
0 -1 S -1 -1 0 -1 0 0
0 0 0 0 -1 0 0 G 0
-1 0 -1 -1 -1 0 -1 0 -1
-1 0 0 -1 -1 0 -1 0 0
0 0 0 0 0 5 F2 -1 0
0 0 -1 -1 -1 -1 0 0 0
-1 -1 -1 0 0 0 0 -1 -1
