9 9 100 100
0 -1 -1 -1 0 -1 -1 0 0
0 S -1 0 0 -1 0 0 -1
0 -1 -1 -1 0 0 0 0 0
0 0 -1 -1 0 0 -1 -1 -1
0 0 -1 0 -1 5 0 0 0
0 -1 0 0 0 0 -1 -1 G
0 -1 -1 -1 -1 3 -1 -1 -1
0 0 0 -1 0 0 0 -1 -1
-1 0 0 0 0 -1 0 0 0