9 9 100 12
0 0 0 0 -1 0 0 0 -1
G -1 0 0 0 0 -1 0 0
-1 -1 0 0 -1 -1 -1 -1 0
-1 -1 -1 0 0 0 -1 -1 0
0 0 0 -1 0 0 -1 -1 -1
0 -1 0 F2 7 0 0 0 -1
-1 0 0 0 -1 -1 -1 0 0
0 0 0 0 0 0 -1 0 -1
-1 0 0 -1 0 -1 S 0 -1