9 9 100 7
0 -1 -1 0 -1 0 -1 -1 0
0 0 -1 F3 0 0 0 0 0
0 0 4 0 -1 -1 0 -1 0
0 0 -1 0 0 -1 0 0 -1
-1 G 0 -1 0 S -1 0 0
0 0 0 0 -1 -1 0 -1 -1
0 -1 0 0 -1 -1 0 0 0
0 -1 -1 0 0 0 0 0 -1
-1 0 0 0 0 0 0 -1 -1