9 9 100 14
0 0 -1 -1 0 0 0 -1 -1
0 0 0 -1 0 0 0 0 0
0 -1 0 -1 -1 -1 -1 0 -1
0 -1 0 0 0 -1 -1 0 -1
0 0 0 -1 -1 -1 0 0 0
0 -1 0 -1 -1 5 0 -1 G
S 0 0 0 -1 0 -1 -1 -1
0 0 0 -1 0 0 -1 0 F4
0 -1 0 0 0 0 0 0 -1